############################################################
#                  #                                       #
#    ###    ~~~    #                                       #
#    @   ~~~       #                                       #
#      ###                                                 #
#        #                                                 #
###################                                        #
###################                                        #
#                                                          #
#    ###    ~~~                                            #
#        ~~~                                               #
#      ###                                                 #
#        #                                                 #
###################                                        #
###################                                        #
#                                                          #
#    ###    ~~~                                            #
#        ~~~                                               #
#      ###                                                 #
#        #                                                 #
############################################################