############################################################
#                  #
#    ###    ~~~    #
#       ~~~       #
#      ###
#        #
###################
###################
#
#    ###    ~~~
#        ~~~
#      ###
#        #
###################
###################
#
#    ###    ~~~
#        ~~~
#      ###
#        #
####################                                                     ~~~~~~~
                                                                    ~~~~~~~~~